78 78 78 78 78 78 78 78 78 78 78 78 78 78 78 78 78 78 78 78 78 78 78 78 78 78 78 78 78 78 78 78 78 78 78 78 78 78 78 78 78 78 78 78 78 78 78 78 78 78 78 78 78 78 78 78 78 78 78 78
78 78 78 78 78 78 78 78 78 78 78 78 78 78 78 78 78 78 78 78 78 78 78 78 78 78 78 78 78 78 78 78 78 78 78 78 78 78 78 78 78 78 78 78 78 78 78 78 78 78 78 78 78 78 78 78 78 78 78 78
78 78 78 78 78 78 78 78 78 78 78 78 78 78 78 78 78 78 78 78 78 78 78 78 78 78 78 78 78 78 78 78 78 78 78 78 78 78 78 78 78 78 78 78 78 78 78 78 78 78 78 78 78 78 78 78 78 78 78 78
78 78 78 78 78 78 78 78 78 78 78 78 78 78 78 78 78 78 78 78 78 78 78 78 78 78 78 78 78 78 78 78 78 78 78 78 78 78 78 78 78 78 78 78 78 78 78 78 78 78 78 78 78 78 78 78 78 78 78 78
78 78 78 78 78 78 78 78 78 78 78 78 78 78 78 78 78 78 78 78 78 78 78 78 78 78 78 78 78 78 78 78 78 78 78 78 78 78 78 78 78 78 78 78 78 78 78 78 78 78 78 78 78 78 78 78 78 78 78 78
78 78 78 78 78 78 78 78 78 78 78 78 78 78 78 78 78 78 78 78 78 78 78 78 78 78 78 78 78 78 78 78 78 78 78 78 78 78 78 78 78 78 78 78 78 78 78 78 78 78 78 78 78 78 78 78 78 78 78 78
78 78 78 78 78 78 78 78 78 78 78 78 78 78 78 78 78 78 78 78 78 78 78 78 78 78 78 78 78 78 78 78 78 78 78 78 78 78 78 78 78 78 78 78 78 78 78 78 78 78 78 78 78 78 78 78 78 78 78 78
78 78 78 78 78 78 78 78 78 78 78 78 78 78 78 78 78 78 78 78 78 78 78 78 78 78 78 78 78 78 78 78 78 78 78 78 78 78 78 78 78 78 78 78 78 78 78 78 78 78 78 78 78 78 78 78 78 78 78 78
78 78 78 78 78 78 78 78 78 78 78 78 78 78 78 78 78 78 78 78 78 78 78 78 78 78 78 78 78 78 468 78 468 468 78 78 78 78 78 78 78 78 78 78 78 78 468 468 468 78 78 78 78 78 78 78 78 78 468 468
468 468 468 468 468 468 36 36 36 36 468 468 468 468 468 468 468 468 468 36 468 468 468 468 468 36 468 318 468 78 468 468 78 468 468 78 468 468 78 78 78 468 78 468 468 78 318 78 468 78 468 78 78 468 78 78 78 78 78 468
468 468 468 468 468 468 468 468 468 468 468 468 468 468 468 468 36 468 468 318 468 468 468 468 468 36 468 318 468 468 468 318 468 468 468 468 468 468 78 78 78 78 468 468 468 468 468 468 468 468 468 468 468 468 468 468 468 468 468 468
468 468 468 468 468 468 468 468 468 468 468 468 468 468 468 468 468 468 468 468 468 468 468 468 36 468 468 468 36 36 468 318 78 468 468 78 468 468 468 468 318 468 468 468 468 468 318 468 468 468 468 468 468 468 468 468 468 468 468 468
468 468 468 468 468 468 468 468 468 468 468 468 468 468 468 468 468 468 468 318 468 468 468 468 468 468 36 36 468 468 468 78 468 468 468 468 468 468 468 468 468 468 468 468 468 468 318 468 468 468 468 468 468 468 468 468 468 468 468 468
468 468 468 468 468 468 468 468 468 468 468 468 468 468 468 468 468 468 468 468 468 468 468 36 318 36 78 468 78 468 468 468 468 468 468 468 468 468 468 468 468 468 468 468 468 468 468 468 468 468 468 468 468 468 468 468 468 468 468 468
468 468 468 468 468 468 468 468 468 468 468 36 468 468 468 468 468 468 318 468 468 36 468 36 318 78 468 468 318 468 468 468 468 468 468 468 468 468 468 468 318 468 468 468 468 468 318 468 468 468 468 468 468 468 468 468 468 468 468 468
468 468 468 468 468 468 468 468 468 468 468 468 468 468 468 468 468 468 318 36 36 468 36 78 318 468 468 468 468 318 318 318 468 468 468 468 468 468 468 468 468 468 468 468 468 468 468 468 468 468 468 468 468 468 468 468 468 468 468 468
468 468 468 468 468 468 468 468 468 468 468 468 468 468 468 318 468 36 318 36 468 78 78 318 468 468 468 468 468 318 318 468 468 468 468 468 468 468 468 468 468 468 468 468 468 468 468 468 468 468 468 468 468 468 468 468 468 468 468 468
468 468 468 468 468 468 468 468 468 468 468 468 468 468 36 318 36 468 318 468 36 78 468 36 468 468 468 468 468 318 318 318 468 468 468 468 468 468 468 468 318 468 78 78 78 468 318 78 468 468 78 468 78 468 468 468 468 468 468 468
468 468 468 468 468 468 468 36 468 36 468 468 36 468 468 318 36 468 318 36 318 78 468 318 468 318 468 318 318 318 318 318 468 468 468 468 468 318 468 78 78 78 468 468 468 468 468 468 468 468 78 78 468 468 468 468 468 468 468 468
468 468 468 468 468 468 468 468 468 36 36 468 468 468 468 468 468 468 318 468 318 468 78 318 78 78 78 468 78 318 78 318 468 78 468 468 318 468 78 468 78 78 318 468 468 78 78 78 78 78 318 468 78 468 78 78 78 468 468 468
468 468 468 468 468 468 468 468 468 36 468 468 318 318 468 468 36 468 318 468 318 318 78 78 468 468 318 468 468 318 78 318 468 468 468 468 78 318 468 78 468 468 318 468 78 468 318 468 468 468 318 468 468 468 468 468 468 468 468 468
468 468 468 468 468 468 468 468 468 36 468 36 318 468 468 318 468 468 318 318 318 318 36 318 36 78 318 468 78 468 78 318 468 468 468 468 468 318 468 468 318 318 318 468 468 468 468 468 468 468 318 468 468 468 468 468 468 468 468 468
468 468 468 468 468 468 468 468 468 36 468 468 318 36 36 468 468 468 318 36 318 318 36 318 468 468 318 468 468 468 78 78 78 468 468 468 468 468 468 468 468 468 318 468 468 468 468 468 468 468 318 468 468 468 468 468 468 468 468 468
468 468 468 468 36 468 468 468 36 36 468 36 318 36 468 318 36 468 78 36 318 318 468 468 78 468 318 468 78 468 78 78 468 468 468 468 468 468 468 468 318 468 318 468 468 468 318 468 468 468 318 468 468 468 468 468 468 468 468 468
468 468 468 468 468 468 36 468 36 36 468 468 318 468 36 36 468 468 318 36 318 318 318 318 468 468 468 468 468 468 318 468 468 468 468 468 468 318 468 468 318 468 318 468 468 468 468 468 468 468 318 468 468 468 468 468 468 468 468 468
468 468 468 36 468 468 468 36 468 468 36 36 318 36 36 36 468 36 468 468 468 468 468 318 318 468 318 468 468 468 468 468 468 468 468 468 468 468 468 468 318 318 318 468 468 468 318 468 468 468 318 468 468 468 468 468 468 468 468 468
36 36 468 468 468 468 36 36 468 468 36 36 318 36 36 318 468 36 468 468 318 468 468 468 318 468 468 468 468 468 318 468 468 468 468 468 468 468 318 318 318 468 318 468 468 468 468 468 468 468 318 468 468 468 468 468 468 468 468 468
36 468 468 468 468 468 468 468 36 468 36 36 318 468 468 468 468 468 318 468 318 468 468 468 468 318 318 468 468 468 468 318 468 468 468 468 468 318 468 468 318 468 468 468 468 468 318 468 468 468 318 468 468 468 468 468 468 468 468 468
468 36 468 468 468 468 468 468 36 36 468 36 318 468 468 468 36 468 468 468 468 468 468 468 468 468 318 468 468 468 318 318 468 318 318 468 468 318 468 468 468 468 318 468 468 468 318 468 468 468 318 468 468 468 468 468 468 468 468 468
468 468 468 468 468 36 36 36 468 468 468 468 318 36 36 468 468 468 468 468 468 468 468 468 468 318 468 468 468 318 318 468 468 468 468 468 468 318 468 468 468 468 318 468 468 468 468 468 468 468 318 468 468 468 468 468 468 468 468 468
36 468 468 468 468 468 36 36 468 468 36 36 468 318 468 318 468 468 318 468 318 468 468 42 42 42 42 42 42 42 42 42 42 42 42 42 42 42 42 42 42 42 42 42 42 468 468 468 468 468 318 468 468 468 468 468 468 468 468 468
468 468 468 468 397 398 398 398 398 398 399 468 468 318 318 468 468 468 468 468 318 468 468 42 42 42 42 42 42 42 42 42 42 42 42 42 42 42 42 42 42 42 42 42 42 468 468 468 468 468 318 468 468 468 468 468 468 468 468 468
468 468 468 468 413 301 286 287 285 301 415 468 468 468 468 318 468 468 468 468 468 468 468 42 42 42 42 42 42 58 42 42 42 42 42 42 42 16 17 17 18 42 42 42 42 468 468 468 468 468 468 468 468 468 468 468 468 468 468 468
468 468 468 316 413 301 302 303 301 301 415 317 468 468 468 318 318 468 468 468 318 468 468 42 42 42 42 42 42 42 42 78 78 78 78 42 42 32 38 41 34 42 42 42 42 468 468 468 468 468 318 468 468 468 468 468 468 468 468 468
468 468 468 318 429 430 430 430 430 430 431 318 468 468 468 318 468 318 468 468 318 468 468 42 42 58 42 42 42 42 42 78 9 10 42 42 42 32 33 33 50 58 42 42 42 468 468 468 468 468 318 468 468 468 468 468 468 468 468 468
468 468 468 318 370 318 389 390 391 392 371 318 468 468 468 318 468 468 468 318 318 468 318 42 42 42 42 42 42 42 42 78 25 26 42 42 42 48 49 50 42 42 42 42 42 468 468 468 468 468 318 468 468 468 468 468 468 468 468 468
468 468 468 318 386 318 405 406 407 408 387 318 468 468 468 318 468 318 468 468 318 346 346 42 42 42 42 148 149 150 42 42 42 42 42 42 42 42 42 42 42 42 42 42 42 468 468 468 468 468 318 468 468 468 468 468 468 468 468 468
468 468 468 318 386 318 423 424 425 426 403 318 468 468 318 318 468 468 468 468 318 346 318 42 42 42 42 164 165 166 42 116 117 118 42 42 42 42 42 42 42 42 42 42 42 468 468 468 468 468 318 468 468 468 468 468 468 468 468 468
468 468 468 318 402 318 439 440 441 442 402 318 468 468 318 468 468 468 468 468 318 346 318 42 42 42 42 180 181 182 42 132 133 134 42 42 42 42 42 42 42 42 42 42 42 468 468 468 468 468 318 468 468 468 468 468 468 468 468 468
468 468 468 332 350 318 350 350 350 350 350 333 468 468 468 468 468 468 468 468 318 346 348 42 42 42 42 42 42 42 42 180 181 182 42 42 42 42 42 42 58 42 42 42 42 468 468 468 468 468 468 468 468 468 468 468 468 468 468 468
468 402 468 468 468 318 468 468 468 468 468 468 468 468 468 468 468 468 468 468 346 346 318 42 42 42 42 42 42 42 42 42 42 42 42 42 42 42 42 42 42 42 42 42 42 468 468 468 468 468 468 468 468 468 468 468 468 468 468 468
36 430 468 468 468 468 468 468 468 468 468 468 468 468 468 468 468 468 468 348 346 346 346 42 42 42 42 42 42 42 42 42 42 42 42 42 42 42 42 42 42 42 42 42 42 468 468 468 468 468 468 468 468 468 468 468 468 468 468 468
468 468 468 468 468 318 468 468 468 468 468 468 468 468 468 468 468 348 468 468 346 346 346 346 346 346 346 468 346 346 346 468 468 346 346 348 318 468 468 468 468 468 468 346 346 468 468 468 468 468 468 468 468 468 468 468 468 468 468 468
468 468 468 468 468 468 468 468 468 468 468 468 468 468 468 468 468 468 468 346 346 346 346 346 346 346 346 346 346 346 346 346 346 348 348 468 468 468 468 468 318 468 468 346 346 468 468 468 468 468 468 468 468 468 468 468 468 468 468 468
468 468 468 468 468 318 468 468 468 468 468 468 468 468 468 348 468 468 468 346 346 348 318 348 346 346 346 346 346 468 468 348 318 468 468 468 318 468 468 468 318 468 468 346 346 468 468 468 468 468 468 468 468 468 468 468 468 468 468 468
468 468 468 468 468 318 468 468 468 468 468 468 468 348 348 468 468 468 468 346 346 468 468 348 346 348 348 346 348 348 468 468 468 468 468 468 318 468 468 468 318 468 468 346 346 468 468 468 468 468 468 468 468 468 468 468 468 468 468 468
468 468 468 468 468 468 468 468 468 468 468 468 348 468 468 468 468 468 346 346 346 468 468 346 346 346 468 318 468 468 468 468 468 468 468 468 468 468 468 468 318 468 468 346 346 468 468 468 468 468 468 468 468 468 468 468 468 468 468 468
468 468 468 468 468 468 468 468 468 468 468 468 348 468 468 468 468 468 468 468 346 468 346 348 468 318 468 468 468 468 468 468 468 468 468 318 468 468 346 346 346 346 346 346 346 468 468 468 468 468 468 468 468 468 468 468 468 468 468 468
468 468 468 468 468 318 468 468 468 468 468 468 348 468 468 348 468 468 348 468 346 346 346 346 346 346 346 346 346 346 346 346 346 346 346 346 346 346 346 346 346 346 346 346 346 468 468 468 468 468 468 468 468 468 468 468 468 468 468 468
468 468 468 468 468 468 468 468 468 468 468 468 468 468 468 468 468 468 468 468 318 468 468 468 468 318 468 468 468 468 468 468 468 468 346 346 346 468 468 468 318 468 468 468 468 468 468 468 468 468 468 468 468 468 468 468 468 468 468 468
468 468 468 468 468 318 468 468 468 468 468 468 468 468 468 468 468 468 468 468 318 468 468 468 468 318 468 468 468 468 468 468 318 468 468 468 468 468 468 468 468 468 468 468 468 468 468 468 468 468 468 468 468 468 468 468 468 468 468 468
468 468 468 468 468 318 468 468 468 468 468 468 468 468 468 468 468 468 468 468 318 468 318 468 468 318 468 468 468 468 468 468 468 468 468 468 468 468 468 468 468 468 468 468 468 468 468 468 468 468 468 468 468 468 468 468 468 468 468 468
468 468 468 468 468 318 468 468 468 468 468 468 468 468 468 468 468 468 468 468 318 468 318 468 468 318 468 468 468 468 468 468 318 468 468 468 468 468 468 468 468 468 468 468 468 468 468 468 468 468 468 468 468 468 468 468 468 468 468 468
468 468 468 468 468 318 468 468 468 468 468 468 468 468 468 468 468 468 468 468 318 468 318 468 468 468 468 468 468 468 468 468 468 468 468 468 468 468 468 468 468 468 468 468 468 468 468 468 468 468 468 468 468 468 468 468 468 468 468 468
468 468 468 468 468 468 468 468 468 468 468 468 468 468 468 468 468 468 468 468 468 468 318 468 468 468 468 468 468 468 468 468 318 468 468 468 468 468 468 468 468 468 468 468 468 468 468 468 468 468 468 468 468 468 468 468 468 468 468 468
468 468 468 468 468 468 468 468 468 468 468 468 468 468 468 468 468 468 468 468 468 468 318 468 468 468 468 468 468 468 468 468 318 468 468 468 468 468 468 468 468 468 468 468 468 468 468 468 468 468 468 468 468 468 468 468 468 468 468 468
468 468 468 468 468 468 468 468 468 468 468 468 468 468 468 468 468 468 468 468 468 468 318 468 468 468 468 468 468 468 468 468 468 468 468 468 468 468 468 468 468 468 468 468 468 468 468 468 468 468 468 468 468 468 468 468 468 468 468 468
468 468 468 468 468 468 468 468 468 468 468 468 468 468 468 468 468 468 468 468 468 468 468 468 468 468 468 468 468 468 468 468 468 468 468 468 468 468 468 468 468 468 468 468 468 468 468 468 468 468 468 468 468 468 468 468 468 468 468 468
468 468 468 468 468 468 468 468 468 468 468 468 468 468 468 468 468 468 468 468 468 468 468 468 468 468 468 468 468 468 468 468 468 468 468 468 468 468 468 468 468 468 468 468 468 468 468 468 468 468 468 468 468 468 468 468 468 468 468 468
468 468 468 468 468 468 468 468 468 468 468 468 468 468 468 468 468 468 468 468 468 468 468 468 468 468 468 468 468 468 468 468 468 468 468 468 468 468 468 468 468 468 468 468 468 468 468 468 468 468 468 468 468 468 468 468 468 468 468 468
