316 100 100 100 100 468 468 468 468 468 468 468 468 468 468 468 468 468 468 468 468 468 468 468 468 468 468 468 468 468 468 468 468 468 468 468 468 468 468 468 468 468 468 468 468 468 468 468 468 468 468 468 468 468 468 468 468 468 468 468
100 100 100 100 100 468 468 468 468 468 468 468 468 468 468 468 468 468 468 468 468 468 468 468 468 468 468 468 468 468 468 468 468 468 468 468 468 468 468 468 468 468 468 468 468 468 468 468 468 468 468 468 468 468 468 468 468 468 468 468
100 100 100 100 100 468 468 41 41 41 41 41 41 41 41 41 41 468 468 318 468 468 468 468 468 468 468 468 468 468 468 468 468 468 468 468 468 468 468 468 468 468 468 468 468 468 468 468 468 468 468 468 468 468 468 468 468 468 468 468
468 468 468 468 468 468 41 41 41 41 41 41 41 41 41 41 41 468 468 318 468 468 468 468 468 468 468 318 468 468 468 468 468 468 468 468 468 468 468 468 468 468 468 468 468 468 468 468 468 468 468 468 468 468 468 468 468 468 468 468
468 468 468 468 468 41 41 41 41 41 41 41 41 41 41 41 41 468 468 318 468 468 468 468 468 468 468 318 468 468 468 318 468 468 468 468 468 468 468 468 468 468 468 468 468 468 468 468 468 468 468 468 468 468 468 468 468 468 468 468
468 468 468 468 41 41 41 41 41 41 41 41 41 41 41 41 468 468 468 318 468 468 468 468 468 468 468 318 468 468 468 318 468 468 468 468 468 468 468 468 468 468 468 468 468 468 318 468 468 468 468 468 468 468 468 468 468 468 468 468
468 468 468 468 468 468 36 36 36 36 36 41 41 41 41 41 468 468 468 318 468 468 468 468 468 468 468 318 468 468 468 318 468 468 468 468 468 468 468 468 468 468 468 468 468 468 318 468 468 468 468 468 468 468 468 468 468 468 468 468
468 468 468 468 468 468 36 36 36 36 36 468 468 468 468 468 468 468 468 468 468 468 468 468 468 468 468 318 468 468 468 318 468 468 468 468 468 468 468 468 468 468 468 468 468 468 318 468 468 468 468 468 468 468 468 468 468 468 468 468
468 468 468 468 468 468 36 36 36 36 36 468 468 468 468 468 468 468 468 468 468 36 468 36 36 468 468 318 468 468 468 318 468 468 468 468 468 468 468 468 318 468 468 468 468 468 468 468 468 468 468 468 468 468 468 468 468 468 468 468
468 468 468 468 468 468 36 36 36 36 468 468 468 468 468 468 468 468 468 36 468 468 468 468 468 36 468 318 468 468 468 468 468 468 468 468 468 468 468 468 318 468 468 468 468 468 318 468 468 468 468 468 468 468 468 468 468 468 468 468
468 468 468 468 468 468 468 468 468 468 468 468 468 468 468 468 36 468 468 318 468 468 468 468 468 36 468 318 468 468 468 318 468 468 468 468 468 468 468 468 318 468 468 468 468 468 468 468 468 468 468 468 468 468 468 468 468 468 468 468
468 468 468 468 468 468 468 468 468 468 468 468 468 468 468 468 468 468 468 468 468 468 468 468 36 468 468 468 36 36 468 318 468 468 468 468 468 468 468 468 318 468 468 468 468 468 318 468 468 468 468 468 468 468 468 468 468 468 468 468
468 468 468 468 468 468 468 468 468 468 468 468 468 468 468 468 468 468 468 318 468 468 468 468 468 468 36 36 468 468 468 468 468 468 468 468 468 468 468 468 468 468 468 468 468 468 318 468 468 468 468 468 468 468 468 468 468 468 468 468
468 468 468 468 468 468 468 468 468 468 468 468 468 468 468 468 468 468 468 468 468 468 468 36 318 36 468 468 318 468 468 468 468 468 468 468 468 468 468 468 468 468 468 468 468 468 468 468 468 468 468 468 468 468 468 468 468 468 468 468
468 468 468 468 468 468 468 468 468 468 468 36 468 468 468 468 468 468 318 468 468 36 468 36 318 468 468 468 318 468 468 468 468 468 468 468 468 468 468 468 318 468 468 468 468 468 318 468 468 468 468 468 468 468 468 468 468 468 468 468
468 468 468 468 468 468 468 468 468 468 468 468 468 468 468 468 468 468 318 36 36 468 36 36 318 468 468 468 468 318 318 318 468 468 468 468 468 468 468 468 468 468 468 468 468 468 468 468 468 468 468 468 468 468 468 468 468 468 468 468
468 468 468 468 468 468 468 468 468 468 468 468 468 468 468 318 468 36 318 36 468 36 36 318 468 468 468 468 468 318 318 468 468 468 468 468 468 468 468 468 468 468 468 468 468 468 468 468 468 468 468 468 468 468 468 468 468 468 468 468
468 468 468 468 468 468 468 468 468 468 468 468 468 468 36 318 36 468 318 468 36 468 468 36 468 468 468 468 468 318 318 318 468 468 468 468 468 468 468 468 318 468 468 468 468 468 318 468 468 468 468 468 468 468 468 468 468 468 468 468
468 468 468 468 468 468 468 36 468 36 468 468 36 468 468 318 36 468 318 36 318 468 468 318 468 318 468 318 318 318 318 318 468 468 468 468 468 318 468 468 468 468 468 468 468 468 468 468 468 468 468 468 468 468 468 468 468 468 468 468
468 468 468 468 468 468 468 468 468 36 36 468 468 468 468 468 468 468 318 468 318 468 468 318 318 468 318 468 468 318 468 318 468 318 468 468 318 468 468 468 318 468 318 468 468 468 468 468 468 468 318 468 468 468 468 468 468 468 468 468
468 468 468 468 468 468 468 468 468 36 468 468 318 318 468 468 36 468 318 468 318 318 318 318 468 468 318 468 468 318 318 318 468 468 468 468 468 318 468 318 468 468 318 468 468 468 318 468 468 468 318 468 468 468 468 468 468 468 468 468
468 468 468 468 468 468 468 468 468 36 468 36 318 468 468 318 468 468 318 318 318 318 36 318 36 468 318 468 468 468 468 318 468 468 468 468 468 318 468 468 318 318 318 468 468 468 468 468 468 468 318 468 468 468 468 468 468 468 468 468
468 468 468 468 468 468 468 468 468 36 468 468 318 36 36 468 468 468 318 36 318 318 36 318 468 468 318 468 468 468 318 318 468 468 468 468 468 468 468 468 468 468 318 468 468 468 468 468 468 468 318 468 468 468 468 468 468 468 468 468
468 468 468 468 36 468 468 468 36 36 468 36 318 36 468 318 36 468 468 36 318 318 468 468 468 468 318 468 468 468 468 318 468 468 468 468 468 468 468 468 318 468 318 468 468 468 318 468 468 468 318 468 468 468 468 468 468 468 468 468
468 468 468 468 468 468 36 468 36 36 468 468 318 468 36 36 468 468 318 36 318 318 318 318 468 468 468 468 468 468 318 468 468 468 468 468 468 318 468 468 318 468 318 468 468 468 468 468 468 468 318 468 468 468 468 468 468 468 468 468
468 468 468 36 468 468 468 36 468 468 36 36 318 36 36 36 468 36 468 468 468 468 468 318 318 468 318 468 468 468 468 468 468 468 468 468 468 468 468 468 318 318 318 468 468 468 318 468 468 468 318 468 468 468 468 468 468 468 468 468
36 36 468 468 468 468 36 36 468 468 36 36 318 36 36 318 468 36 468 468 318 468 468 468 318 468 468 468 468 468 318 468 468 468 468 468 468 468 318 318 318 468 318 468 468 468 468 468 468 468 318 468 468 468 468 468 468 468 468 468
36 468 468 468 468 468 468 468 36 468 36 36 318 468 468 468 468 468 318 468 318 468 468 468 468 318 318 468 468 468 468 318 468 468 468 468 468 318 468 468 318 468 468 468 468 468 318 468 468 468 318 468 468 468 468 468 468 468 468 468
468 36 468 468 468 468 468 468 36 36 468 36 318 468 468 468 36 468 468 468 468 468 468 468 468 468 318 468 468 468 318 318 468 318 318 468 468 318 468 468 468 468 318 468 468 468 318 468 468 468 318 468 468 468 468 468 468 468 468 468
468 468 468 468 468 36 36 36 468 468 468 468 318 36 36 468 468 468 468 468 468 468 468 468 468 318 468 468 468 318 318 468 468 468 468 468 468 318 468 468 468 468 318 468 468 468 468 468 468 468 318 468 468 468 468 468 468 468 468 468
36 468 468 468 468 468 36 36 468 468 36 36 468 318 468 318 468 468 318 468 318 468 468 468 468 468 318 468 468 318 318 318 468 468 468 468 468 318 468 468 468 468 318 468 468 468 468 468 468 468 318 468 468 468 468 468 468 468 468 468
468 468 468 468 397 398 398 398 398 398 399 468 468 318 318 468 468 468 468 468 318 468 468 468 468 468 318 318 468 318 318 318 468 468 468 468 468 318 468 468 318 468 318 468 468 468 468 468 468 468 318 468 468 468 468 468 468 468 468 468
468 468 468 468 413 301 286 287 285 301 415 468 468 468 468 318 468 468 468 468 468 468 468 468 468 318 318 468 468 318 468 318 468 318 468 468 468 318 468 468 318 468 318 468 468 468 468 468 468 468 468 468 468 468 468 468 468 468 468 468
468 468 468 316 413 301 302 303 301 301 415 317 468 468 468 318 318 468 468 468 318 468 468 468 318 468 318 318 468 318 468 318 468 318 468 468 468 318 468 468 318 468 318 468 468 468 468 468 468 468 318 468 468 468 468 468 468 468 468 468
468 468 468 318 429 430 430 430 430 430 431 318 468 468 468 318 468 318 468 468 318 468 468 468 318 468 468 468 468 318 468 318 468 318 468 468 468 468 468 468 468 468 468 468 468 468 468 468 468 468 318 468 468 468 468 468 468 468 468 468
468 468 468 318 370 318 389 390 391 392 371 318 468 468 468 318 468 468 468 318 318 468 318 468 318 468 468 318 468 318 468 318 468 468 468 468 468 468 468 468 318 468 468 468 468 468 468 468 468 468 318 468 468 468 468 468 468 468 468 468
468 468 468 318 386 318 405 406 407 408 387 318 468 468 468 318 468 318 468 468 318 318 318 318 318 468 468 468 468 468 468 318 468 318 468 468 318 468 468 468 468 468 468 468 468 468 468 468 468 468 318 468 468 468 468 468 468 468 468 468
468 468 468 318 386 318 423 424 425 426 403 318 468 468 318 318 468 468 468 468 318 468 318 468 468 468 468 468 468 318 468 318 468 318 468 468 318 468 468 468 318 468 468 468 468 468 468 468 468 468 318 468 468 468 468 468 468 468 468 468
468 468 468 318 402 318 439 440 441 442 402 318 468 468 318 468 468 468 468 468 318 468 318 468 468 468 468 468 318 318 468 318 468 318 468 468 318 468 468 468 468 468 468 468 468 468 468 468 468 468 318 468 468 468 468 468 468 468 468 468
468 468 468 332 350 318 350 350 350 350 350 333 468 468 468 468 468 468 468 468 318 468 318 468 468 468 468 468 468 318 468 468 468 468 468 468 318 468 468 468 318 468 468 468 468 468 468 468 468 468 468 468 468 468 468 468 468 468 468 468
468 402 468 468 468 318 468 468 468 468 468 468 468 468 468 468 468 468 468 468 468 468 318 468 468 468 468 468 318 318 468 468 468 468 468 468 318 468 468 468 468 468 468 468 468 468 468 468 468 468 468 468 468 468 468 468 468 468 468 468
36 430 468 468 468 468 468 468 468 468 468 468 468 468 468 468 468 468 468 468 318 468 318 468 468 468 468 468 468 468 468 468 318 468 468 468 468 468 468 468 318 468 468 468 468 468 468 468 468 468 468 468 468 468 468 468 468 468 468 468
468 468 468 468 468 318 468 468 468 468 468 468 468 468 468 468 468 468 468 468 468 468 318 468 468 468 468 468 318 468 468 468 468 468 468 468 318 468 468 468 468 468 468 468 468 468 468 468 468 468 468 468 468 468 468 468 468 468 468 468
468 468 468 468 468 468 468 468 468 468 468 468 468 468 468 468 468 468 468 468 318 468 318 468 468 468 468 468 468 468 468 468 468 468 468 468 468 468 468 468 318 468 468 468 468 468 468 468 468 468 468 468 468 468 468 468 468 468 468 468
468 468 468 468 468 318 468 468 468 468 468 468 468 468 468 468 468 468 468 468 468 468 318 468 468 318 468 468 318 468 468 468 318 468 468 468 318 468 468 468 318 468 468 468 468 468 468 468 468 468 468 468 468 468 468 468 468 468 468 468
468 468 468 468 468 318 468 468 468 468 468 468 468 468 468 468 468 468 468 468 468 468 468 468 468 318 468 318 468 468 468 468 468 468 468 468 318 468 468 468 318 468 468 468 468 468 468 468 468 468 468 468 468 468 468 468 468 468 468 468
468 468 468 468 468 468 468 468 468 468 468 468 468 468 468 468 468 468 468 468 318 468 468 468 468 318 468 318 468 468 468 468 468 468 468 468 468 468 468 468 318 468 468 468 468 468 468 468 468 468 468 468 468 468 468 468 468 468 468 468
468 468 468 468 468 468 468 468 468 468 468 468 468 468 468 468 468 468 468 468 468 468 468 468 468 318 468 468 468 468 468 468 468 468 468 318 468 468 468 468 318 468 468 468 468 468 468 468 468 468 468 468 468 468 468 468 468 468 468 468
468 468 468 468 468 318 468 468 468 468 468 468 468 468 468 468 468 468 468 468 318 468 468 468 468 318 468 468 468 468 468 468 318 468 468 318 468 468 468 468 318 468 468 468 468 468 468 468 468 468 468 468 468 468 468 468 468 468 468 468
468 468 468 468 468 468 468 468 468 468 468 468 468 468 468 468 468 468 468 468 318 468 468 468 468 318 468 468 468 468 468 468 468 468 468 318 468 468 468 468 318 468 468 468 468 468 468 468 468 468 468 468 468 468 468 468 468 468 468 468
468 468 468 468 468 318 468 468 468 468 468 468 468 468 468 468 468 468 468 468 318 468 468 468 468 318 468 468 468 468 468 468 318 468 468 468 468 468 468 468 468 468 468 468 468 468 468 468 468 468 468 468 468 468 468 468 468 468 468 468
468 468 468 468 468 318 468 468 468 468 468 468 468 468 468 468 468 468 468 468 318 468 318 468 468 318 468 468 468 468 468 468 468 468 468 468 468 468 468 468 468 468 468 468 468 468 468 468 468 468 468 468 468 468 468 468 468 468 468 468
468 468 468 468 468 318 468 468 468 468 468 468 468 468 468 468 468 468 468 468 318 468 318 468 468 318 468 468 468 468 468 468 318 468 468 468 468 468 468 468 468 468 468 468 468 468 468 468 468 468 468 468 468 468 468 468 468 468 468 468
468 468 468 468 468 318 468 468 468 468 468 468 468 468 468 468 468 468 468 468 318 468 318 468 468 468 468 468 468 468 468 468 468 468 468 468 468 468 468 468 468 468 468 468 468 468 468 468 468 468 468 468 468 468 468 468 468 468 468 468
468 468 468 468 468 468 468 468 468 468 468 468 468 468 468 468 468 468 468 468 468 468 318 468 468 468 468 468 468 468 468 468 318 468 468 468 468 468 468 468 468 468 468 468 468 468 468 468 468 468 468 468 468 468 468 468 468 468 468 468
468 468 468 468 468 468 468 468 468 468 468 468 468 468 468 468 468 468 468 468 468 468 318 468 468 468 468 468 468 468 468 468 318 468 468 468 468 468 468 468 468 468 468 468 468 468 468 468 468 468 468 468 468 468 468 468 468 468 468 468
468 468 468 468 468 468 468 468 468 468 468 468 468 468 468 468 468 468 468 468 468 468 318 468 468 468 468 468 468 468 468 468 468 468 468 468 468 468 468 468 468 468 468 468 468 468 468 468 468 468 468 468 468 468 468 468 468 468 468 468
468 468 468 468 468 468 468 468 468 468 468 468 468 468 468 468 468 468 468 468 468 468 468 468 468 468 468 468 468 468 468 468 468 468 468 468 468 468 468 468 468 468 468 468 468 468 468 468 468 468 468 468 468 468 468 468 468 468 468 468
468 468 468 468 468 468 468 468 468 468 468 468 468 468 468 468 468 468 468 468 468 468 468 468 468 468 468 468 468 468 468 468 468 468 468 468 468 468 468 468 468 468 468 468 468 468 468 468 468 468 468 468 468 468 468 468 468 468 468 468
468 468 468 468 468 468 468 468 468 468 468 468 468 468 468 468 468 468 468 468 468 468 468 468 468 468 468 468 468 468 468 468 468 468 468 468 468 468 468 468 468 468 468 468 468 468 468 468 468 468 468 468 468 468 468 468 468 468 468 468
